X                                                                                        X
X                                                                                        X
X                                                                                        X
X                                                                                        X
X                                                                                        X
X                                                                                        X
X                                                                                        X
X                                                                                        X
X                                                                                        X
X                                                                                        X
X                                      XX                                                X
X                                                                                        X
X                                                                                        X
X                                                                                        X
X                                                                                        X
XXX    XXXXXX    XXXXXXXXXXXXXX     XXXXXXXXXXXXXXXXXX   XXXXXXXXXXX     XXXXXXXXXXXXXXXXX
X                                                                                        X
X                                                                                        X
X                                                                                        X
XXXXXXXXXXXXX    XXXXXXXXXXXXXXXXXXXXXXXXXXXXXXXXXXXXX   XXXXXXXXXXXXXXXXXXXXXXXXXXXXXXXXX
X                                                                                        X
X                                                                                        X
XXXXXXXXXXXXXXXXXXXXXXXXXXXXXXXXXXXXXXXXXXXXXXXXXXXXXXXXXXXXXXXXXXXXXXXXXXXXXXXXXXXXXXXXXX
